+ Idle
10	10
2	3
^	^	^	.	.	.	.	.	.	.
.	^	.	.	.	-	-	-	-	-
.	.	.	.	.	-	.	.	.	.
.	.	.1	.	-	-	.	.	.	.
.	.	^	-	-	^	^	.	.	.
.	^	^	-	^	~	~	~	.	.
.	^	-	-	~	~	~	.	.	.
-	-	-	.	~	~	~	.	.	.
^	^	.	.	.	.	^	.	.	.
.	^	^	.	.	.	.	.	.	.

Replica Hello, how are you?| 0
    Fine| -1

Replica So fine I| 0
